env7;
s;
ssFbbkxrm;
T . . . . . # T # . . . . . T
# # # # . # # . # # . # # # #
. . # . 8 # A . B # 9 . # . .
# . # 6 . V . . . V . 7 # . #
. . # . . V x x x V . . # . .
. # # 4 . V x x x V . 5 # # .
. . # . . V x x x V . . # . .
# . # 0 . V V V V V . 1 # . #
. . # . 2 . . . . . 3 . # . .
. # # # # # # # # # # # # # .
. . . . . . A . B . . . . . .